159.231.63.0/24,"ASN 14121"
159.231.95.0/24,"ASN 7741"
199.198.223.0/24,"ASN 14121"
199.198.234.0/24,"ASN 14121"
199.198.238.0/24,"ASN 7741"
