45.220.0.0/19,"ASN 327901"
102.141.128.0/18,"ASN 327901"
102.215.100.0/22,"ASN 327901"
102.216.196.0/22,"ASN 327901"
102.217.108.0/22,"ASN 327901"
102.217.200.0/22,"ASN 327901"
102.217.224.0/22,"ASN 327901"
102.218.240.0/22,"ASN 327901"
102.219.116.0/22,"ASN 327901"
102.220.148.0/22,"ASN 327901"
102.221.120.0/22,"ASN 327901"
102.222.168.0/22,"ASN 327901"
169.255.196.0/22,"ASN 327901"
196.201.232.0/21,"ASN 327901"
